
34,34,34,34,34,34,34,34,34,34,34,34,34,34,34,34,34,34,34,34,
34,0,0,0,0,0,0,34,0,0,0,0,0,0,0,34,0,0,0,34,
34,0,0,0,0,0,0,34,0,0,0,0,0,0,0,0,0,0,0,34,
34,0,0,0,0,0,0,34,0,0,0,0,0,0,0,0,0,0,0,34,
34,0,0,0,0,0,0,34,0,0,0,0,0,0,0,34,0,0,0,34,
34,0,0,0,0,0,0,34,0,0,0,0,0,0,0,34,0,0,0,34,
34,34,34,34,0,0,34,34,34,34,34,34,34,34,34,34,0,0,0,34,
34,0,0,0,0,0,0,34,0,0,0,0,0,0,0,34,0,0,0,34,
34,0,0,0,0,0,0,34,0,0,0,0,0,0,0,0,0,0,0,34,
34,0,0,34,0,0,0,34,0,0,0,0,0,0,0,0,0,0,0,34,
34,0,0,34,0,0,0,34,0,0,0,0,0,0,0,34,0,0,0,34,
34,0,0,34,0,0,0,34,0,0,0,0,0,0,0,34,0,0,0,34,
34,0,0,34,0,0,0,34,0,0,0,0,0,0,0,34,0,0,0,34,
34,0,0,34,0,0,0,34,0,0,34,34,34,34,34,34,0,0,0,34,
34,0,0,34,0,0,0,0,0,0,0,0,0,0,0,34,0,0,0,34,
34,0,0,34,0,0,0,0,0,0,0,0,0,0,0,34,0,0,0,34,
34,0,0,34,34,0,0,34,0,0,34,34,34,34,34,34,34,34,34,34,
34,0,0,0,0,0,0,34,0,0,0,0,0,0,0,0,0,0,0,34,
34,0,0,0,0,0,0,34,0,0,0,0,0,0,0,0,0,0,0,34,
34,34,34,34,34,34,34,34,34,34,34,34,34,34,34,34,34,34,34,34

;

0,0,0,0,0,0,0,0,0,0,0,0,0,0,0,0,0,0,0,0,
0,130,130,130,130,130,130,0,130,130,130,130,130,130,130,0,130,130,130,0,
0,130,130,130,130,130,130,0,130,130,130,130,130,130,130,130,130,130,130,0,
0,130,130,130,130,130,130,0,130,130,130,130,130,130,130,130,130,130,130,0,
0,130,130,130,130,130,130,0,130,130,130,130,130,130,130,0,130,130,130,0,
0,130,130,130,130,130,130,0,130,130,130,130,130,130,130,0,130,130,130,0,
0,0,0,0,130,130,0,0,0,0,0,0,0,0,0,0,130,130,130,0,
0,130,130,130,130,130,130,0,130,130,130,130,130,130,130,0,130,130,130,0,
0,130,130,130,130,130,130,0,130,130,130,130,130,130,130,130,130,130,130,0,
0,130,130,0,130,130,130,0,130,130,130,130,130,130,130,130,130,130,130,0,
0,130,130,0,130,130,130,0,130,130,130,130,130,130,130,0,130,130,130,0,
0,130,130,0,130,130,130,0,130,130,130,130,130,130,130,0,130,130,130,0,
0,130,130,0,130,130,130,0,130,130,130,130,130,130,130,0,130,130,130,0,
0,130,130,0,130,130,130,0,130,130,0,0,0,0,0,0,130,130,130,0,
0,130,130,0,130,130,130,130,130,130,130,130,130,130,130,0,130,130,130,0,
0,130,130,0,130,130,130,130,130,130,130,130,130,130,130,0,130,130,130,0,
0,130,130,0,0,130,130,0,130,130,0,0,0,0,0,0,0,0,0,0,
0,130,130,130,130,130,130,0,130,130,130,130,130,130,130,130,130,130,130,0,
0,130,130,130,130,130,130,0,130,130,130,130,130,130,130,130,130,130,130,0,
0,0,0,0,0,0,0,0,0,0,0,0,0,0,0,0,0,0,0,0

;

0,0,0,0,0,0,0,0,0,0,0,0,0,0,0,0,0,0,0,0,
0,0,0,0,0,0,0,0,0,0,0,0,0,0,0,0,0,0,0,0,
0,0,0,0,0,0,0,0,0,0,0,0,0,0,0,0,0,0,0,0,
0,0,0,0,0,0,0,0,0,0,0,0,0,0,0,0,0,0,0,0,
0,0,0,0,0,0,0,0,0,0,0,0,0,0,0,0,354,354,354,0,
0,0,0,0,0,0,0,0,0,0,0,0,0,0,0,0,0,0,0,0,
0,0,0,0,354,354,0,0,0,0,0,0,0,0,0,0,0,0,0,0,
0,0,0,0,0,0,0,0,0,0,0,0,0,0,0,0,0,0,0,0,
0,0,0,0,0,0,0,0,0,0,0,0,0,0,0,354,0,0,0,0,
0,0,0,0,354,354,354,0,0,0,0,0,0,0,0,354,0,0,0,0,
0,0,0,0,0,0,0,0,0,0,0,0,0,0,0,0,0,0,0,0,
0,0,0,0,0,0,0,0,0,0,0,0,0,0,0,0,0,0,0,0,
0,0,0,0,0,0,0,0,0,0,0,0,0,0,0,0,0,0,0,0,
0,0,0,0,0,0,0,0,354,354,0,0,0,0,0,0,0,0,0,0,
0,0,0,0,0,0,0,354,0,0,0,0,0,0,0,0,0,0,0,0,
0,0,0,0,0,0,0,354,0,0,0,0,0,0,0,0,0,0,0,0,
0,0,0,0,0,0,0,0,0,0,0,0,0,0,0,0,0,0,0,0,
0,0,0,0,0,0,0,0,0,0,354,354,0,0,0,0,0,0,0,0,
0,0,0,0,0,0,0,0,0,0,354,354,0,0,0,0,0,0,0,0,
0,0,0,0,0,0,0,0,0,0,0,0,0,0,0,0,0,0,0,0

;

0,0,0,0,0,0,0,0,0,0,0,0,0,0,0,0,0,0,0,0,
0,0,0,0,0,0,0,0,0,0,0,0,0,0,0,0,0,0,0,0,
0,0,0,0,0,0,0,0,0,0,0,0,0,0,0,0,0,0,0,0,
0,0,0,0,0,0,0,0,0,0,0,0,0,0,0,0,0,0,0,0,
0,0,0,0,0,0,0,0,0,0,0,0,0,0,0,0,0,0,0,0,
0,0,0,0,0,0,0,0,0,0,0,0,0,0,0,0,0,0,0,0,
0,0,0,0,0,0,0,0,0,0,0,0,0,0,0,0,0,0,0,0,
0,0,0,0,0,0,0,0,0,0,0,0,0,0,0,0,0,0,0,0,
0,0,0,0,0,0,0,0,0,0,0,0,0,0,0,0,0,0,0,0,
0,0,0,0,0,0,0,0,0,0,0,0,0,0,0,0,0,0,0,0,
0,0,0,0,0,0,0,0,0,0,0,0,0,0,0,0,0,0,0,0,
0,0,0,0,0,0,0,0,0,0,0,0,0,0,0,0,0,0,0,0,
0,0,0,0,0,0,0,0,0,0,0,0,0,0,0,0,0,0,0,0,
0,0,0,0,0,0,0,0,0,0,0,0,0,0,0,0,0,0,0,0,
0,0,0,0,0,0,0,0,0,0,0,0,0,0,0,0,0,0,0,0,
0,0,0,0,0,0,0,0,0,0,0,0,0,0,0,0,0,0,0,0,
0,0,0,0,0,0,0,0,0,0,0,0,0,0,0,0,0,0,0,0,
0,0,0,0,0,0,0,0,0,0,0,0,0,0,0,0,0,0,0,0,
0,0,0,0,0,0,0,0,0,0,0,0,0,0,0,0,0,0,358,0,
0,0,0,0,0,0,0,0,0,0,0,0,0,0,0,0,0,0,0,0

;

0,0,0,0,0,0,0,0,0,0,0,0,0,0,0,0,0,0,0,0,
0,0,0,0,432,0,0,0,0,0,0,0,0,0,0,0,0,432,0,0,
0,0,0,0,0,0,0,0,0,432,0,0,0,0,0,0,0,0,0,0,
0,0,0,0,0,0,0,0,0,0,0,0,0,0,0,0,0,0,0,0,
0,0,0,0,0,0,0,0,0,0,0,0,0,0,0,0,0,0,0,0,
0,0,0,0,0,0,0,0,0,0,0,0,0,0,0,0,0,0,0,0,
0,0,0,0,0,0,0,0,0,0,0,0,0,0,0,0,0,0,0,0,
0,0,0,0,0,0,432,0,0,0,432,0,0,432,0,0,0,0,0,0,
0,0,0,0,0,0,0,0,0,0,0,0,0,0,0,0,0,0,0,0,
0,0,0,0,0,0,0,0,0,0,0,0,0,0,0,0,0,0,0,0,
0,0,0,0,0,0,0,0,0,0,0,0,0,0,0,0,0,0,0,0,
0,0,0,0,0,0,0,0,0,0,0,0,0,0,0,0,0,0,0,0,
0,0,0,0,0,0,0,0,0,0,0,0,0,0,0,0,0,0,0,0,
0,0,0,0,0,0,0,0,0,0,0,0,0,0,0,0,0,0,0,0,
0,0,0,0,0,0,0,0,0,0,0,0,0,0,432,0,0,0,0,0,
0,0,0,0,432,0,0,0,0,0,0,0,0,0,0,0,0,0,0,0,
0,0,0,0,0,0,0,0,0,0,0,0,0,0,0,0,0,0,0,0,
0,0,0,0,0,0,0,0,0,0,0,0,0,0,0,432,0,0,0,0,
0,0,0,0,0,0,0,0,0,0,0,0,0,0,0,0,0,0,0,0,
0,0,0,0,0,0,0,0,0,0,0,0,0,0,0,0,0,0,0,0

;

0,0,0,0,0,0,0,0,0,0,0,0,0,0,0,0,0,0,0,0,
0,0,0,0,0,0,0,0,0,0,0,0,0,0,0,0,0,0,0,0,
0,0,0,0,0,0,0,0,0,0,0,0,0,0,0,0,0,0,0,0,
0,0,0,0,0,0,0,0,0,0,0,0,0,0,0,0,0,0,0,0,
0,0,0,0,0,0,0,0,0,0,0,0,0,0,0,0,0,0,0,0,
0,0,0,0,0,0,0,0,0,0,0,0,0,0,0,0,0,0,0,0,
0,0,0,0,0,0,0,0,0,0,0,0,0,0,0,0,0,0,0,0,
0,0,0,0,0,0,0,0,0,0,0,0,0,0,0,0,0,0,0,0,
0,0,0,0,0,0,0,0,0,0,0,0,0,0,0,0,0,0,0,0,
0,0,0,0,0,0,0,0,0,0,0,0,0,0,0,0,0,0,0,0,
0,0,0,0,0,0,0,0,0,0,0,531,0,0,0,0,0,0,0,0,
0,0,0,0,0,0,0,0,0,0,0,0,0,0,0,0,0,0,0,0,
0,0,0,0,0,0,0,0,0,0,0,0,0,0,0,0,0,0,0,0,
0,0,0,0,0,0,0,0,0,0,0,0,0,0,0,0,0,0,0,0,
0,0,0,0,0,0,0,0,0,0,0,0,0,0,0,0,0,531,0,0,
0,0,0,0,0,0,0,0,0,0,0,0,0,0,0,0,0,0,0,0,
0,0,0,0,0,0,0,0,0,0,0,0,0,0,0,0,0,0,0,0,
0,0,0,0,0,0,0,0,0,0,0,0,0,0,0,0,0,0,0,0,
0,0,531,0,0,0,0,0,0,0,0,0,0,0,0,0,0,0,0,0,
0,0,0,0,0,0,0,0,0,0,0,0,0,0,0,0,0,0,0,0

;

0,0,0,0,0,0,0,0,0,0,0,0,0,0,0,0,0,0,0,0,
0,0,0,0,0,0,0,0,0,0,0,0,0,0,0,0,0,0,0,0,
0,0,0,0,0,0,0,0,0,0,0,0,531,0,0,0,0,0,0,0,
0,0,0,531,0,0,0,0,0,0,0,0,0,0,0,0,0,533,0,0,
0,0,0,0,0,0,0,0,0,0,531,0,0,0,0,0,0,0,0,0,
0,0,0,0,0,0,0,0,0,0,0,0,0,0,0,0,0,0,0,0,
0,0,0,0,0,0,0,0,0,0,0,0,0,0,0,0,0,0,533,0,
0,0,0,0,0,0,0,0,0,0,0,0,0,0,0,0,0,0,0,0,
0,533,0,0,0,0,0,0,0,0,0,0,0,0,0,0,0,533,0,0,
0,0,0,0,0,0,0,0,0,0,0,0,0,0,0,0,533,0,0,0,
0,0,533,0,0,0,0,0,0,0,0,0,0,0,0,0,0,0,0,0,
0,0,0,0,0,0,0,0,0,0,0,0,0,0,0,0,0,0,0,0,
0,0,0,0,0,533,0,0,0,0,0,0,0,0,0,0,0,531,0,0,
0,0,0,0,0,0,0,0,0,0,0,0,0,0,0,0,0,0,0,0,
0,0,0,0,0,0,533,0,0,0,0,0,0,0,0,0,0,0,0,0,
0,0,0,0,0,0,0,0,0,0,533,0,0,0,0,0,0,0,531,0,
0,531,0,0,0,0,0,0,0,0,0,0,0,0,0,0,0,0,0,0,
0,0,0,0,0,0,0,0,0,0,0,0,0,0,0,0,0,533,0,0,
0,0,0,0,0,531,0,0,531,0,0,0,0,0,0,0,533,0,0,0,
0,0,0,0,0,0,0,0,0,0,0,0,0,0,0,0,0,0,0,0